11111111111111111111111
10000000000P000C0000011
1000000CCC00000E0000011
11111111111111111111111