1111111111111
10000000001P1
10000000001C1
11111111111E1
1111111111111