111111111111111111111111
1000000000C00000E00P0001
10000011011CC000C0000011
111111111111111111111111
