111111111111111111111111
1P00000000C00000000C0001
10000011111CC000C00C0011
10000011011CC000C0000011
10000011011CC000C0000111
10000011011CC000C000E111
111111111111111111111111
