111111111111111111111111
1P00000000C00000000C0001
100000110110C000C00C0011
10000011011C0000C0000011
100000110110C000C0000111
10000C11C11C0000C000E111
111111111111111111111111
