11111111111111111111111
10000000000000000000001
1P000011E11CC0000000001
11111111111111111111111