11111111111111111111111
10000000P000P000E000001
1001110011011000000E011
11111111111111111111111