11111111111111111111111
1000000000000000000EP11101
1001110011011000000C11110101
11111111111111111111111