11111111111111111111111
10000000000000000000EP1
1001110011011000000C011
11111111111111111111111