11111111111111111111111000
11111111C111111111111P1
100000000000000CC000001
1C111111111C11111111111
10000000000000000000E11
11111111111111111111111