1111111111111
10000000001P1
10000000001E1
11111111111C1
1111111111111