11111111111111111111111
111111111111111111111P1
100000000000000CC000001
10111111111111111111111
1000E111100000000000011
11111111111111111111111