111111111111111111111111
10000E0000C000000000011
1000011110000000P000011
11111111111111111111111