11111111111111111111111
1000000000000000EC000P1
10011100110110000000001
1111111111111111111111100