11111111111111
100000000000P1
10000000000C01
11111111111111
10000E00000001
11111111111111
