sadasdasdas6d4as6d54asd
asdasdasdasdasdasdasdasd
11111111asasdasdasd
100E1001asdasdasd
11101P01asdasdas
aq1010C0C1asdasda
11111111asdasd
asdasdasdasd