111111111111111111111111rth0
1P00000000C00000000C0001trht
100000110110C000C00C0011trhr
10000011011C0000C0000011hhrt
100000110110C000C0000111trh
10000C11C11C0000C000E111thr
111111111111111111111111trhr
