11111111111111
100000000000P1
10000000000E01
11111111111111
10000C00000001
11111111111111
