111111111111111111111111
1P10001000100CCCCCCCCCC1
1E10101010101CCCCCCCCCC1
10101010101C1CCCCCCCCCC1
1010101C1C101CCC0CCCCCC1
10001C0C100C1CCCCCCCC111
111111111111111111111111