111111111111111111111111
1P10001000100CCCCCCCCCC111
1010101010101CCCCCCCCCC1
10101010101C1CCCCCCCCCC1
1010101C1C101CCCCCCCCCC1
10001C0C100C1CCCCCCCE111
111111111111111111111111