111111111111111111111111
1P10001000100CCCCCCCCCC1
1010101010100CCCCCCCCCC1
10101010101C0CCCCCCCCCC1
10101E1C1C100CCCCCCCCCC1
10001C0C101C0CCCCCCC0111
111111111111111111111111